Alemanya=Berlín
Andorra=Andorra
Àustria=Viena
Bèlgica=Brussel·les
Dinamarca=Copenhaguen
Espanya=Madrid
Finlàndia=Hèlsinki
França=París
Grècia=Atenes
Holanda=Amsterdam
Irlanda=Dublín
Itàlia=Roma
Noruega=Oslo
Polònia=Varsòvia
Portugal=Lisboa
Regne Unit=Londres
Rússia=Moscou
Suècia=Estocolm
Suïssa=Berna
Turquia=Ankara
Angola=Luanda
Algèria=Alger
Camerun=Yaoundé
Egipte=El Caire
Eritrea=Asmara
Etiòpia=Addis Abeba
Kenya=Nairobi
Líbia=Tríopoly
Marroc=Rabat
Nigèria=Abuja
República del Congo=Kinshasa
República Sud-Àfrica=Tshwane
Senegal=Dakar
Sudan=Khartum
Tunísia=Tunis
Txad=N'Djaména